*$	Starbucks
*$$	Starbucks
02	My two cents
0773H	Hello
10m	Ten man
10q	Thank you
10x	Thanks
121	One to one
1337	Leet
143	I love you
1432	I love you too
143444	I love you very very much
14AA41	One for all, all for one
182	I hate you
187	Code for murder
1ce	Once
1D	One Direction
1i	One eye
1up	Extra life
2	To
20	Location
22	Tutu
24/7	Twenty-four hours a day, seven days a week
25m	Twenty-five man
262	Old
26y4u	Too sexy for you
2B	To be
2B@	To be at
2BZ4UQT	Too busy for you, cutie
2C	Too cool
2C4U	Too cool for you
2day	Today
2DFM	Too dumb for me
2EZ	Too easy
2FB	Too freaking bad
2G2BT	Too good to be true
2H2H	Too hot to handle
2k	Talk
2l8	Too late
2M2H	Too much to handle
2M2M	Too many too mention
2MFM	Too much for me
2MI	Too much information
2moro	Tomorrow
2morrow	Tomorrow
2moz	Tomorrow
2mr	Tomorrow
2mrw	Tomorrow
2nite	Tonight
2nt	Tonight
2U2	To you too
2ZDA	Tuesday
303	Mom
360-noscope	360 no scope
3arc	Treyarch
3EB	Third Eye Blind
3q	Thank you
3RZDA	Thursday
3sum	Threesome
4	For
404	Page not found
411	Information
420	Marijuana
458	I love you
459	I love you
4AYN	For all you know
4COL	For crying out loud
4EAE	Forever and ever
4eva	Forever
4ever	Forever
4get	Forget
4gm	Forgive me
4got	Forgot
4MTK	For Me To Know
4n	Foreign
4OTS	For old time's sake
4q	F*** you
4rl	For real
4sale	For sale
4sho	For sure
4U	For you
4U2	For you too
4ward	Forward
4WD	Four-wheel drive
511	Too much information
5150	Crazy
555	Laughing
5FDP	Five Finger Death Punch
5FS	Five Finger Salute
6y	Sexy
8	Ate
831	I love you
8TB	Ate the bait
9	Parent in room
99	Parent has left
@@-o	Tattletale
@TEOTD	At the end of the day
^5	High five
{}	No comment

A	Hey
A/S/L	Age/sex/location
A/S/L/P	Age, sex, location, picture
A2D	Agree to disagree
A2T	Addicted to texting
A3	Anyplace, anywhere, anytime
A7X	Avenged Sevenfold
AA	As above
AA	Adios amigo
aa	Autoattack
AAF	As a friend
AAF	Always and forever
AAK	Alive and kicking
AAMOF	As a matter of fact
AAP	Always a pleasure
AAR	At any rate
aar8	At any rate
aarping	Elderly person complaining repeatedly
AAS	Alive and smiling
AAWC	After awhile crocodile
AAYF	As always, your friend
abbrev	Abbreviation
ABCP	A bad computer professional
abt	About
abt2	About to
AC	Air conditioning
ACD	Alt-Control-Delete
Ace	Solo winner
ack	Acknowledged
AD	Attack damage
ADAD	Another day another dollar
ADAM	All draft all mid
ADBB	All done, bye-bye
ADC	Attack damage carry
add	Address
adds	Additional mobs
addy	Address
ADIH	Another day in Hell
ADIP	Another day in paradise
ADM	Ay dios mio
admin	Administrator
ADN	Any day now
ADPIC	Always Dependably Politically Incorrect
ADS	Aiming down sight
AE	Area of effect
AEAP	As early as possible
AF	Aggression factor
AFAIAC	As far as I am concerned
AFAIC	As far as I'm concerned
AFAICS	As far as I can see
AFAICT	As far as I can tell
AFAIK	As far as I know
AFAIR	As far as I remember
AFAP	As fast as possible
AFAYC	As far as you're concerned
AFC	American Football Conference
AFC	Away from controller
AFC	Away from computer
AFHV	America's Funniest Home Videos
AFJ	April Fools' joke
AFK	Away from keyboard
AFN	All for now
AFPOE	A fresh pair of eyes
Afro	Natural bush-like hairstyle
AFU	All f***ed up
AFV	America's Funniest Videos
AFWIW	Anyway, for what it's worth
aggro	Aggression
agi	Agility
agl	Angel
AH	Auction house
AH	At home
AHFY	Always here for you
AI	As if
AI	All in
AI	Artificial intelligence
aight	Alright
AIM	AOL Instant Messenger
AIMB	As I mentioned before
Aimbot	Automatic aiming bot
AIME	As I mentioned earlier
AIMP	Always in my prayers
AIP	Agreement in principle
aipf	All in preflop
Airhead	Stupid
AISB	As I said before
AISE	As I said earlier
AISI	As I see it
AIUI	As I understand it
AJ	Absolute jerk
ak	AK-47
AKA	Also known as
AL	American League
ALAP	As long as possible
ALOL	Actually laughing out loud
alt	A lot
alt	Alternate character
AM	Antemeridian
AMAP	As much as possible
Amazeballs	Amazing
amazn	Amazing
AMBL	All my boundless love
AMBW	All my best wishes
AMF	Adios my friend
AMG	Ah my gosh
AML	All my love
ammo	Ammunition
amp	To be loud and angry
Amped	Pumped up
AMS	Ask me something
ANFSCD	And now for something completely different
anon	Anonymous
ANTM	America's Next Top Model
anuda	Another
AOAS	All of a sudden
AOC	Available on cell
AOE	Area of effect
AOI	A** on ice
AOL	America Online
AOMM	Always on my mind
AON	All or nothing
AON	Apropos of nothing
AON	As of now
AOTA	All of the above
AOYP	Angel on your pillow
AP	Attached Parenting
AP	Ability power
AP	Attack power
APC	A Perfect Circle
APM	Actions per minute
app	Application
app	Appreciate
AR	Assault rifle
ARAM	All random all mid
arp	Armor penetration
arpen	Armor penetration
ARTS	Action real-time strategy
AS	Attack speed
ASAIC	As soon as I can
ASAIK	As soon as I know
ASAP	As soon as possible
ASAT	As simple as that
ASAYC	As soon as you can
ASAYGT	As soon as you get this
ASL	Age, sex, location
ASLP	Age, sex, location, picture
ASP	After show party
ASYC	As soon as you can
ATB	All the best
ATM	At the moment
ATM	Automated teller machine
ATPM	About to pee myself
ATSL	Along the same lines
ATST	At the same time
ATT	All the time
attaboy	Good job
attn	Attention
Attny	Attorney
ATTT	Ain't that the truth
Attwicted	Addicted to Twitter
ATW	All the way
ATYS	Anything you say
AUT	Are you there
Automagically	Magically automatic
AWA	As well as
Awesomesauce	Super awesome
AWHFY	Are we having fun yet?
awks	Awkward
AWL	Always with love
AWLTP	Avoiding work like the plague
AWOL	Absent while online
AWT	At what time
AWTY	Are we there yet?
AYAOTD	Are You Afraid of the Dark?
AYBABTU	All your base are belong to us
AYC	Are you coming?
AYFR	Are you for real?
AYFT	Are you free today?
AYK	As you know
AYKM	Are you kidding me?
AYOR	At your own risk
AYPI	And your point is?
AYS	Are you serious?
AYSOS	Are you stupid or something?
AYT	Are you there?
AYTMTB	And you're telling me this because
AYW	As you wish
AYW	As you were
AYWK	As you well know
azm	Awesome
azn	Asian
azz	A**

b	Be
B&F	Back and forth
B&W	Black and white
b-day	Birthday
b/c	Because
b/f	Brain fart
b/f	Boyfriend
b/r	Bathroom
b/w	Between
B1G1	Buy one, get one
B2W	Back to work
b4	Before
B4N	Bye for now
BA	Bad A**
BA	B**** a**
BAA	Broad agency announcement
BAC	Back at computer
BAF	Bring a friend
Bai	Bye
BAIC	Boy am I confused
BAK	Back at keyboard
Baller	Cool person
BAMF	Bad a** mother f*****
Barcraft	Bar gathering for StarCraft
BASOR	Breathing a sigh of relief
BAT	B**** a** trick
BB	Bye bye
BB	Big blind
BB	Be back
BB	Bright blessings
BB	Breaking Bad
BB	Blessed be
bb/100	Big bets per 100 hands
BB4N	Bye bye for now
BBB	Boring beyond belief
BBFN	Bye-bye for now
BBIAB	Be back in a bit
BBIAM	Be back in a minute
BBL	Be back later
BBM	Brains by Mattel
BBML	Be back much later
BBN	Bye bye now
BBOL	Be back on later
bbq	Barbecue
BBS	Be back soon
BBS	Bulletin board system
BBSS	Be back soon sweetie
BBT	Be back tomorrow
BBW	Be back whenever
BBW	Big black women
BBW	Big beautiful women
BBWL	Be back way later
BC	Back cover
BC	Burning Crusade
bc	Because
BC	Be cool
BCBG	Bon Chic Bon Genre
BCC	Blind carbon copy
BCNU	Be seein' you
BCO	Big crush on
bcos	Because
bcoz	Because
bcz	Because
bd	Backdoor
BD	Blu-ray
BD	Big deal
bd	Birthday
bday	Birthday
BDU	Brain dead user
beamer	BMW vehicle
Beast	Awesome person
Beef	Bothering problem
beemer	BMW vehicle
BEG	Big evil grin
belf	Blood Elf
Benjamin	One hundred dollar bill
Bennifer	Ben and Jennifer
Bestie	Best Friend
bf	Boyfriend
BF	B.F. Sword
BF2	Battlefield 2
BFD	Big freakin' deal
BFF	Best friends forever
BFF4L	Best friends forever for life
BFFAE	Best friends forever and ever
BFFE	Best friends forever
BFFL	Best friend for life
BFFLAB	Best friend for life and beyond
BFFM	Best friends forevermore
BFFN	Best friend for now
BFG	Big friggin' gun
BFH	B**** from h***
BFK	Big fat kiss
BFN	Big fat negative
BFN	Bye for now
BFP	Big fat positive
BFR	Big freakin' rock
BFTD	Best friends till death
BFU	Brain free user
BFU	Bezny Franta uzivatel
BG	Bad game
BG	Blood Glucose
bg	Battleground
BG	Big grin
BGF	Best guy friend
BGR	Boy girl relationship
BH	Bloody hell
BH	Better half
BH@	Be home at
bhl8	Be home late
BHS	Be home soon
BI5	Back in five
BIAB	Back in a bit
BIAM	Back in a minute
bibi	Bye bye
BIC	Butt in chair
biffles	Best friends for life
BIL	Boss is listening
BIL	Brother-in-law
BIN	Buy it now
BIO	Bring it on
Bio	Biological units
bio	Bathroom
Bioball	Biological unit group
BION	Believe it or not
BIOYA	Blow it out your a**
BIS	Best in slot
BISLY	But I still love you
BITMT	But in the meantime
BITS	Back in the saddle
biz	Business
BK	Back
BK	Burger King
BKA	Better known as
BL	Buddy list
BL	Belly laughing
bling	Baneling
Bling	Overly flashy jewelry
blinkie	Coupon dispenser machine
Blizz	Blizzard
blog	Web log
blops	Black Ops
BLTN	Better late than never
BLUF	Bottom line up front
blvmot	Believe me on that
BM	Bad manner
BM	Bite me
BMA	Best mates always
BMBO	Blow my brains out
BME	Based on my experience
BMGWL	Busting my gut with laughter
BMW	Boy Meets World
BMW	Bayerische Motoren Werke
BN	Bad news
BNIB	Brand new in box
BNO	Boys night out
BNR	But not really
BO	Build order
BO	Body odor
BO	Back off
BO3	Best of three
BO5	Best of five
BOC	Butt on chair
BOE	Bind on equip
BOGO	Buy one, get one
BOHICA	Bend over here it comes again
BOL	Be on later
Boomkin	Moonkin druid
BOOMS	Bored out of my skull
Boomstick	Doom shotgun
Boosting	Unfair level boosting
Bootsie	Boring person
Bootylicious	Attractive female's rear
Booze	Alcohol
BOP	Bind on pickup
BOS	Brat over shoulder
Boss	Awesome person
bot	Bottom lane
BOT	Be on that
BOT	Back on topic
BOTB	Back of the book
BOTD	Benefit of the doubt
Bounce	Leave
bout	About
boyds	Back off you dipstick
BP	Blue pilling
BR	Bathroom
BR	Bank roll
BR	Best regards
BR	Blu-ray
brah	Bro
Brangelina	Brad and Angelina
BRB	Be right back
BRB	Bathroom break
BRBRB	Bathroom, be right back
BRBS	Be right back soon
brd	Bored
Bread	Money
brez	Battle resurrection
BRH	Be right here
Bridezilla	Godzilla bride
Brillz	Brilliant
BRO	Be right over
Bro	Brother
Bromance	A non-sexual friendship between two or more males
Brony	Male viewer of My Little Pony
broom	Bathroom
BRRRB	Be rrright back
BRT	Be right there
BS	Blood Sugar
BS	Bull s***
BSB	Backstreet Boys
BSOD	Blue screen of death
BST	But seriously though
bstd	Busted
BSTS	Better safe than sorry
BTA	But then again
BTAIM	Be that as it may
BTCHF	Bye, take care, have fun
BTD	Bored to death
BTDT	Been there, done that
BTHO	Back the heck off
bthrm	Bathroom
BTHU	Back the heck up
BTK	Back to keyboard
BTM	Bite me
BTN	Better than nothing
BTOBS	Be there or be square
BTSOOM	Beats the shizzle out of me
BTW	By the way
BTWITIAILWU	By the way, I think I am in love with you
BTWITIAILWY	By the way, I think I am in love with you
BTWITIILWY	By the way, I think I'm in love with you
BTWITILY	By the way, I think I love you
BTWN	Between
BU&I	Between you and I
Bubi	Goodbye
Buck	Dollar
Budder	Gold
BUF	Big, ugly, fat
BUF	Big ugly fellow
Buff	Strengthen
Buhbye	Bye
bump	Forum post message bump
Bunnies	First-person shooter jumping
bup	Backup Plan
Butter	Gold
BW	Best wishes
BW	Be well
BWBR	Brunette with blonde roots
BWDIK	But what do I know
BWG	Big Wide Grin
BWL	Bursting with laughter
BWQ	Buzzword quotient
BWTHDIK	But what the heck do I know
BWTM	But wait, there's more
BYH	Bless your heart
BYKI	Before you know it
BYKT	But you knew that
BYOB	Bring your own beer
BYOD	Bring your own device
BYODKM	Bring your own display, keyboard, and mouse
BYTM	Better you than me
bz	Busy

c	See
C&G	Chuckle and grin
c-p	Sleepy
C/O	Care of
c/p	Crossposting
C/S	Change subject
C2C	Cam to cam
C4N	Ciao for now
C9	Parent in room
Cab	Taxi
CAC	Cool as a cucumber
CAD	Control-alt-delete
Camping	Holding position
Carry	MOBA player role
CAS	Clothing Acquisition Syndrome
cata	Cataclysm
CB	Chris Brown
CBA	Can't be ar**d
CBF	Can't be bothered
CC	I understand
CC	Carbon copy
CC	Credit card
CC	Crowd control
CC	Command Center
CCG	Collectible card game
CCR	Creedence Clearwater Revival
cd	Cooldown
CD9	Parents are watching
CD99	Parents are no longer watching
CDIWY	Couldn't do it without you
cdr	Cooldown reduction
ceebs	Can't be bothered
cell	Cell phone
CFS	Care for a secret?
CFV	Call for votes
CG	Computer Graphics
CGM	Continuous Glucose Monitoring
CGMS	Continuous Glucose Monitoring System
char	Character
chargelot	Charge Zealot
Cheerio	Goodbye
Cheers	Congratulations
Cheers	Regards
Cheese	Cheap strategy
Cheesy	Corny
Chibi	Miniature Character
Chill	Relax
Chillax	Chill and relax
Chingo	Chat lingo
Chirp	Diss
Choob	Skilled player who intentionally plays badly
Chrismukkah	Christmas and Hanukkah
Chu	You
chx	Chickens
cia	See ya
CICU	Can I see you?
CICYH	Can I copy your homework
CICYHW	Can I copy your homework
CID	Consider it done
CIL	Check in later
CIP	Customer initiated payment
CIP	Cell it please
Circle button	Spin move
CIS	Consumer Information Service
CM	Call me
CMB	Call me back
CME	Checking my e-mail
CMFWIC	Chief mo fo of who's in charge
CMIIW	Correct me if I'm wrong
cmon	Come on
CMS	Content Management System
CNP	Continued next post
CNRHKYITF	Chuck Norris roundhouse kick you in the face
COA	Course of action
COB	Close of business
COC	Code of conduct
COD	Call of Duty
COL	Crying out loud
combo	Combination
comp	Computer
convo	Conversation
coo	Cool
COS	Child over shoulder
CP	Club Penguin
CPE	Coolest Person Ever
CQC	Close quarters combat
CRAFT	Can't remember a freakin' thing
Cray	Crazy
CRB	Come right back
CRBT	Crying real big tears
Creeper	A socially invasive person
Creeper	Hostile mobs
Crew	Group of friends
Crib	House
Crimbo	Christmas
crit	Critical Strike
CRN	Chuckling right now
CRS	Can't remember stuff
CRTLA	Can't remember the three letter acronym
crz	Crazy
CS	ChatSlang.com
CS	Caesarean section
CS	Creep score
CSB	Cool story, bro
CSG	Chuckle snicker grin
CSL	Can't stop laughing
CTC	Call the cell
CTF	Capture the flag
CTFU	Cracking the f*** up
CTHU	Cracking the heck up
CTM	Chuckle to myself
CTM	Complete the Monument
CTN	Can't talk now
CTO	Check this out
ctr	Center
CTRN	Can't talk right now
CTS	Change the subject
CU	See you
CU2	See you too
cu2mr	See you tomorrow
CU46	See you for sex
CU@	See you around
CUB	Call you back
cud	Could
CUL	Catch you later
CUL	See you later
CUL	Call you later
cul8r	Call you later
cul8r	See you later
cul8rm8	See you later m8
CULA	See you later alligator
CUOL	See you online
CUS	See you soon
Cushty	Cool
cuz	Because
CWOT	Complete waste of time
CWYL	Chat with you later
CX	Correction
cya	See ya
cyal8r	See you later
CYB	Call you back
CYDI	Can ya dig it
CYE	Check your e-mail
CYF	Check your Facebook
CYFB	Check your Facebook
CYL	Catch ya later
CYM	Check your MySpace
CYO	See you online
CYOA	Cover your own a**
cyr	Call your
CYT	See you tomorrow
CYWW2BY	See ya, wouldn't want to be ya
cz	Because

D/C	Don't care
d/c	Disconnected
d/l	Download
D/S	Dominant/Submissive
D3	Diablo 3
d8	Date
da	The
DA	Dumb a**
DAH	Dumb a** hole
dal	Dalaran
DAQ	Dumb asked question
dat	That
Dbag	Douchebag
DBD	Don't be dumb
DBEYR	Don't believe everything you read
DBG	Don't be gay
DBM	Deadly Boss Mods
DBMN	Don't bug me now
DBS	Dad behind shoulder
DBTS	Don't believe their s***
DBTS	Don't believe that stuff
dc	Daycare
dc	Disconnect
dced	Disconnected
DD	Dear daughter
DDG	Drop dead gorgeous
DDSOS	Different day, same old stuff
de	Disenchant
deagle	Desert Eagle
Debuff	Weakening effect
Dece	Decent
ded	Dead
deeps	Damage per second
deets	Details
def	Definitely
def	Defense
DEGT	Don't even go there
delish	Delicious
dept	Department
Der	Duh
derp	Expression of stupidity
dewd	Dude
DF	Dear fiance
dfg	Deathfire Grasp
DFL	Dead freaking last
DFTBA	Don't forget to be awesome
DGA	Don't go anywhere
DGA	Digital guardian angel
DGARA	Don't give a rat's a**
DH	Dear hubby
DH	Dear husband
DHTC	Don't hit the cell
DHYB	Don't hold your breath
DIAF	Die in a fire
Dibs	Rights to something
Dig	Like
Digits	Phone number
DIIK	Darned if I know
DIKU	Do I know you?
DIKY	Do I know you?
DIL	Daughter-in-law
DILLIGAF	Do I look like I give a flip?
DILLIGAFF	Does it look like I give a flying flip?
Ding	Level up
DINK	Double income no kids
Dip	Idiot
Dip	Leave
Dis	Disrespect
Dis	This
disc	Discipline
Diss	Disrespect
DISTOL	Did I say that out loud?
DITG	Down in the gutter
Ditto	Same
Diva	Rude woman
DIY	Do it yourself
DK	Don't know
DKDC	Don't know, don't care
DKP	Dragon kill points
DL	Down low
DL	Doing Laundry
dl	Download
dlc	Downloadable content
DLM	Don't leave me
DLO	Down low
DLTBBB	Don't let the bed bugs bite
DLTCU	Don't let them catch you
DLTM	Don't lie to me
DM	Death match
DM	Direct message
DM	Do me
DMB	Dave Matthews Band
dmg	Damage
DMI	Don't mention it
DMNDS	Doesn't make no dang sense
DMY	Don't mess yourself
dnbl8	Do not be late
DND	Do not disturb
DNFTT	Do not feed the trolls
dno	Don't know
dnt	Don't
DOA	Dead on arrival
DOC	Drug of choice
DOM	Dirty old man
Dome	Head
Domed	Headshotted
DON	Double or nothing
Doo	Excrement from a human or an animal
doo	Dude
Doo-doo	Child term for human or animal excrement
Dope	Cool
Dope	Drugs
DOS	Dad over shoulder
DOT	Damage over time
DOTA	Defense of the Ancients
Douche	Douchebag
Douchebag	Arrogant jerk
Doucheling	Partial douchebag
Dough	Money
Dougie	Dance move
DP	Dear partner
DPS	Damage per second
dq	Disqualify
DQMOT	Don't quote me on this
DQOTD	Dumb question of the day
DQYDJ	Don't quit your day job
DRC	Don't really care
DRK	Don't really know
DS	Dear son
DSI	Don't sweat it
DSR	Detailed seller rating
dstr8	Dang straight
DT	Dang typos
DT	Dark templar
DT	Dream Theater
DTF	Down to f***
DTR	Define the relationship
DTRT	Do the right thing
DU	Don't understand
DU	Darn you
DUCT	Did you see that?
Duh	Overly obvious
DUK	Didn't you know?
DULM	Do you love me
Dunking	Owning enemy player
dunno	I don't know
dur	Stupidly obvious
DUR	Do you remember
DUST	Did you see that?
DUUT	Do you understand that?
DW	Dear wife
DW	Don't worry
DWB	Don't write back
DWBH	Don't worry, be happy
Dweet	Drunk tweet
DWHTGTTA	Do we have to go through this again
DWISNWID	Do what I say, not what I do
DWL	Dying with laughter
DWT	Driving while texting
DWTS	Dancing with the Stars
DX	Driving
DYD	Don't you dare
DYFI	Did you find it
DYHAB	Do you have a boyfriend?
DYHAG	Do you have a girlfriend?
DYJHIW	Don't you just hate it when
DYK	Did you know
DYLM	Do you love me
DYLM	Do you like me
DYM	Did you mean
DYTTH	Did you talk to her?
DYTTH	Did you talk to him?

e-ok	Electronically OK
e1	Everyone
ea	Each
EA	Electronic Arts
EAK	Eating at keyboard
Effin	F***ing
EG	For example
EG	Evil grin
EI	Eat it
EIE	Enough is enough
Elo	Elo rating system
ELO	Electric Light Orchestra
em	E-mail
ema	E-mail address
emc2	Genius
EMI	Excuse my ignorance
EML	Email me later
emo	Emotional
emsg	E-mail Message
Engrish	Bad Asian to English translation
enuf	Enough
EOD	End of discussion
EOF	End of file
EOL	End of lecture
EOL	End of line
EOL	End of life
EOM	End of message
EOR	End of rant
EOT	End of thread
EPM	Effective actions per minute
EPO	Erythropoietin
Ermahgerd	Oh my gosh
Errz	Errors
ESAD	Eat s*** and die
eSports	Electronic sports
essench	Essential
ETA	Estimated time of arrival
ETA	Edited to add
ETD	Estimated time of departure
EUC	Excellent used condition
Eva	Ever
every1	Everyone
evs	Whatever
Exp	Experience
EYC	Excited yet calm
ez	Easy
ezpz	Easy peasy
ezy	Easy

f	Female
F/F	Face to face
F11	Finger Eleven
F2F	Face to face
F2P	Free to play
F2T	Free to talk
f9	Fine
fab	Fabulous
Facepalm	To place the palm of your hand on your face
Facestalking	Looking through someone's pictures on Facebook
FAF	Funny as fluff
FAH	Funny as heck
Fail	Failure
Fanboy	Big fan
FAQ	Frequently Asked Questions
farming	Earning experience and items
fav	Favorite
fave	Favorite
favs	Favorites
FAWC	For anyone who cares
fb	Facebook
fb	Feedback
fbc	Facebook Chat
fbf	Facebook friend
FBM	Fine by me
fbo	Facebook official
FBOW	For better or worse
FBTW	Fine, be that way
FC	Fingers crossed
FCFS	First-come, first-served
FCOL	For crying out loud
FE	Finger Eleven
feat	Featuring
feds	Federal agents
fella	Fellow person
Fetch	Cool
FF	Flying Fadoodle
FF	Freeze frame
FF	Friends forever
FF	Focus fire
FF	Final Fantasy
FF	Fast forward
FF	Faerie fire
FF5	Family Force 5
FFA	Free for all
FFDP	Five Finger Death Punch
FFE	Forge fast expand
FFF	Fight for first
FFS	For f***'s sake
FFWE	Finds fault with everything
FGS	For goodness sake
FGSQTC	For gosh's sake quit the crap
FH	F***ing Heck
FH	Future husband
FHO	Friends Hanging Out
FICCL	Frankly, I couldn't care less
FIFO	First in, first out
FIL	Father-in-law
Finna	Fixing to
FISH	First in still here
FITB	Fill in the blanks
FLA	Four letter acronym
Flex	To show off
FMI	For more information
FMJ	Full metal jacket
FML	F*** my life
fn	Fine
FNB	Football and beer
FNG	Flippin' new guy
FO	Freaking out
FO	Far out
FOAF	Friend of a friend
FOB	Fresh off the boat
FOC	Free of charge
FOCL	Falling off the chair laughing
FOFL	Falling on the floor laughing
FOFLMAO	Falling on the floor laughing my a** off
FOMO	Fear of missing out
FOOMCL	Falling out of my chair laughing
FORD	Found on road dead
FORD	Flipped Over and Rebuilt Dodge
FORGIVE	Faith, Obedience, Righteousness, Grace, Inheritance, Victory, Edify
FOS	Figure of speech
FOS	Freedom of speech
FOS	Feat of strength
FOTCL	Falling off the chair laughing
FOTD	Face of the day
FOTFL	Falling on the floor laughing
FOTFLMAO	Falling on the floor laughing my a** off
FOTFLOL	Falling on the floor, laughing out loud
FOUO	For official use only
Fox	Attractive woman
FP	Flight point
FPS	First-person shooter
FPS	Frames per second
FR	For real
frag	Player kill
Frealz	For real
Freebie	Free item
Fresh	Cocky
Fresh	Cool
Fresh	Brand new
frnd	Friend
fro	Afro
FS	For sale
FS	Full Screen
FSBO	For sale by owner
FSR	For some reason
FTBOMH	From the bottom of my heart
FTC	Failure to communicate
FTEL	For the epic loss
FTEW	For the epic win
FTF	Face to face
FTFOI	For the fun of it
FTFY	Fixed that for you
FTG	For the group
FTK	For the kill
FTL	For the loss
FTMFW	For the mother f***ing win
FTMP	For the most part
FTP	File transfer protocol
FTR	For the record
ftr	After
FTTB	For the time being
FTTT	From time to time
FTW	For the win
FU	F*** you
FU	Fully understood
FUBAR	Fouled up beyond all recognition
FUCT	Failed under continuous testing
FUD	Fear, uncertainty, and doubt
FUM	Fouled up mess
FUSIT	Fouled up situation
FUT	Follow up to
FVF	Final value fee
fw	Freeware
FW	Future wife
fwd	Forward
FWIW	For what it's worth
FWM	Fine with me
FYA	For your amusement
FYE	For your entertainment
FYEO	For your eyes only
FYF	From your friend
FYI	For your information
FYKI	For your kind information
FYL	F*** your life
FYM	For your misinformation

g	Grin
g/f	Girlfriend
G1	Good one
G2B	Going to bed
G2CU	Good to see you
G2G	Good to go
G2G	Gotta go
G2GGS2D	Got to go get something to drink
G2GIAM	Got to go in a minute
G2GP	Got to go pee
G2P	Gone to pee
G2PB	Got to pee badly
G2R	Got to run
G2TU	Got to tell you
G4I	Go for it
G4N	Good for nothing
G4U	Good for you
G6	Gulfstream G650
g8r	Gator
G9	Goodnight
G9	Genius
GA	Go ahead
GA	Good afternoon
GAD	Get a dictionary
GAG	Got any gossip?
GAL	Get a life
GALMA	Go away, leave me alone
Gamer	Video game player
Gank	Steal
GAS	Gear Acquisition Syndrome
GAS	Greetings and salutations
Gat	Gun
Gawd	God
GAWMA	Go ahead, whet my appetite
GB	Guild bank
gb	Goodbye
GB2W	Get back to work
GBA	Gameboy Advance
GBFN	Goodbye for now
GBH	Great big hug
GBH&K	Great big hug and kiss
GBHK	Great big hug and kiss
GBR	Garbled beyond recovery
GBTTD	Got better things to do
GBTW	Get back to work
GBY	God bless you
GC	Good Crib
GC	Groovy cat
GD	Good day
GD	Green Day
GD&H	Grinning, ducking, and hiding
GD&R	Grinning, ducking, and running
GD&RVF	Grinning, ducking, and running very fast
GDR	Grinning, ducking, running
GE	Good evening
Gerd	Oh my gosh!
GF	Gluten-Free
gf	Girlfriend
GFETE	Grinning from ear to ear
GFG	Good friggin' game
GFN	Gone for now
GFTD	Gone for the day
GFU	Good for you
GFY	Go f*** yourself
GFY	Good for you
GG	Good grief
GG	Good game
GGA	Good game all
GGG	Gotta get a grip
GGG	Giggle
GGGB	Good girl gone bad
GGL	Good game loser
gglords	Broodlords
GGOGG	Great gobs of goose grease
GGOH	Gotta get out of here
GGP	Gotta go pee
ggs	Good games
Ghosting	Observing an enemy player
GI	Glycemic Index
GI	Good idea
gibs	Giblets
GIC	God's in control
GICBTS	Gosh, I can't believe that stuff
GICNBY	Gosh, I cannot believe you
GIG	God is good
GIGO	Garbage in, garbage out
Ginger	Red-head
git	Get over it
GIWISI	Gee, I wish I said it
GIWIST	Gee, I wish I'd said that
GJ	Good job
GJP	Good job partner
GK	Go know
GL	Get lost
GL	Good luck
GL&GH	Good luck and good hunting
GL2U	Good luck to you
GLE	Good luck everyone
GLHF	Good luck have fun
GLHFTTYL	Good luck, have fun, talk to you later
GLWT	Good luck with that
gm	Grandmaster
GM	Good morning
GM	Game master
GM	Good match
GM	Good move
gma	Grandma
GMAB	Give me a break
GMAFB	Give me a friggin' break
GMTA	Great minds think alike
GMV	Got my vote
gn	Goodnight
GN	Get naked
GNE1	Good night everyone
gnight	Good night
gnite	Goodnight
GNO	Girls night out
GNOC	Get naked on camera
GNR	Guns N' Roses
GNST	Good night, sleep tight
Gogo	Go now
GOK	God only knows
GOL	Groaning out loud
GOL	Giggle out loud
GOLF	Gentlemen only, ladies forbidden
GOMB	Get off my back
GOML	Get on my level
gonna	Going to
Goon	Idiot
gorge	Gorgeous
Gosu	Highly skilled
GOT	Game of Thrones
Gotcha	I get you
GOTY	Game of the Year
GOW	Gears of War
GOW2	Gears of War 2
GOWI	Get on with it
GOWM	Go out with me
GP	Go private
gpa	Grandpa
GPA	Grade point average
GPOY	Gratuitous picture of yourself
GPOYW	Gratuitous picture of yourself Wednesday
GPS	Global positioning system
GPS	God's positioning system
gpw	Global Password
GR	Gotta Run
GR&D	Grinning, running, and ducking
gr8	Great
grats	Congratulations
gratz	Congratulations
Gravy	Good
Griefer	Irritating player
Griefing	Irritating other players
Grill	Face
Grinding	Playing long hours
grl	Girl
grr	Anger
grrlz	Girls
GS	Good shot
GS	Gear score
GSHIWMP	Giggling so hard I wet my pants
GSL	Global StarCraft League
GSOH	Great sense of humor
GSTL	Global StarCraft Team League
GSW	Got some weed
GT2T	Got time to talk
GTA	Grand Theft Auto
GTF	Gone too far
GTFO	Get the f*** out
GTFOOH	Get the f*** out of here
GTG	Good to go
GTG	Got to go
GTK	Good to know
GTL	Gym, Tan, Laundry
GTM	Giggle to myself
GTPB	Got to pee badly
GTR	Got to run
gtrdun	Get 'er done
GTSY	Glad to see you
GU	Gently used
gud	Good
GUFN	Grounded until further notice
gv	Give
gvn	Given
GW	Good work
GYFO	Get your freak on
GYSR	Gosh, you're so random
gz	Congratulations

H	Hug
H&K	Hugs and kisses
H/O	Hold on
H/P	Hold please
H/U	Hook up
h/w	Homework
H/W	Husband and wife
H4U	Hot for you
h4x0r	Hacker
h8	Hate
h8r	Hater
h8t	Hate
H9	Husband in room
HA	Hello again
HABD	Have a blessed day
HAG1	Have a good one
HAGA	Have a good afternoon
HAGD	Have a good day
HAGN	Have a good night
HAGO	Have a good one
HAGS	Have a great summer
HAGW	Have a good week
haha	Laughing
hai	Hi
HAK	Hugs and kisses
HAN	How about now?
HAND	Have a nice day
Hangry	Angry because you're hungry
Hater	Someone who's angry or jealous of someone
Haterade	The drink of someone who disapproves of another's actions/lifestyle
hav	Have
hax	Hacks
Haxor	Hacker
HAY	How are you
HB	Hurry back
HB	Hug back
HB2U	Happy birthday to you
HBBD	Happy belated birthday
hbd	Happy birthday
HBO	Home Box Office
HBU	How 'bout you
HBY	How about you?
HC	How cool
HCIT	How cool is that
HDYLMN	How do you like me now
HE	Hold'em
hehe	Laughing
HF	Have fun
HFC	Holy freaking crap
HGH	Human growth hormone
HH	Ha-ha
HH	Holding hands
HH1/2KO	Ha-ha, half-kidding only
HHIS	Hanging head in shame
HHJK	Ha-ha, just kidding
HHOJ	Ha-ha only joking
HHOJ/K	Ha-ha, only just kidding
HHOK	Ha-ha only kidding
HHOS	Ha-ha, only serious
HHSF	Ha-ha, so funny
HHVF	Ha-ha, very funny
hi5	High five
HIG	How's it going?
HIH	Hope it helps
HIMYM	How I Met Your Mother
Hipster	Alternative subculture
HIWTH	Hate it when that happens
HK	Hugs and kisses
HK	Hello Kitty
HL	Half-Life
HLBD	Happy late birthday
HLM	He loves me
hlp	Help
hm	Home
HM	Hard mode
HML	Hate my life
HMP	Half marathon pace
hmp	Humph
HMP	Help me, please
hmph	Statement of disdain
HMS	Hanging myself
HMSL	Holding my sides laughing
HMT	Here's my try
HMU	Hit me up
hmwk	Homework
HO	Hold on
HOAS	Heck of a shot
HOAS	Hold on a second
HOF	Hall of fame
HOIC	Hold on, I'm coming
holla	Holler
HOM	Hit or miss
hon	Honey
HON	Heroes of Newerth
hood	Neighborhood
Hoops	Basketball
HOPE	Have Only Positive Expectations
HOPE	Highlights of Personal Experience
Horribad	Horribly bad
HORU	How old are you
HOS	Husband over shoulder
Hot	Beautiful
HOT	Heal over time
Hot-tea	Hottie
HOTS	Heart of the Swarm
Hottie	Attractive person
HP	Hit points
hp	Handphone
hp5	Health per five seconds
HPDC	Happy People Don't Complain
HPS	Heals per second
HPT	Home pregnancy test
hr	Home run
HR	Human resources
hr	Homeroom
HRU	How are you
hry	Hurry
HS	Head shot
HS	High school
HSIK	How should I know
HSM	High school musical
HSMP	Homeschool me please
HT	Hi there
HT	Heard Through
HT	Hat Tip
HTC	Hit the cell
HTF	Hard to find
HTH	Hope this helps
HTN	High time now
HTSUS	Hope to see you soon
HU	Hang up
HU	Hook up
HU	Hold up
Hubby	Husband
Huckleberry	The one you're looking for
HUD	Heads up display
HUD	How you doing?
hun	Honey
Huzzah	Hooray
hw	Homework
hw	Hardware
HWGA	Here we go again
HWIK	How would I know
hwk	Homework
HWP	Height weight proportionate
HWU	Hey, what's up?
hxc	Hardcore
HY	Heck yeah
HYE	Have you ever
HYFR	Heck ya, freakin' right
HYL	Help You Later
H^	Hook up

I8	I ate
I8U	I hate you
IA	I agree
IAB	In a bit
IAC	In any case
IAD	It all depends
IAE	In any event
IAG	It's all good
IAGSMSOL	I am getting some money sooner or later
IAGW	In a good way
IAIL	I am in love
IAM	In a minute
IANAL	I am not a lawyer
IAP	In-app purchase
iat	Alright
IAW	In accordance with
IAWMP	I almost wet my pants
IAWTC	I agree with the comment
IAYF	It's all your fault
IB	I'm back
IB2D	I beg to differ
IBTL	In before the lock
IC	I see
IC	In character
ICBW	I could be wrong
icc	Icecrown Citadel
ICCL	I couldn't care less
ICE	In case of emergency
Ice	Diamonds
ICHC	I Can Has Cheezburger?
ICHI	I can't help it
ICL	In Christian Love
ICO	In concern of
ICO	In care of
ICOCBW	I could, of course, be wrong
icurnvs	I see you are envious
ICWYM	I see what you mean
ICYC	In case you're curious
ICYMI	In case you missed it
ID10T	Idiot
IDC	I don't care
idd	Indeed
IDEK	I don't even know
iDevice	Apple Hardware
IDFK	I don't freaking know
IDGAF	I don't give a f***
IDGI	I don't get it
IDGRA	I don't give a rat's a**
IDHI	I don't have it
IDI	I doubt it
IDK	I don't know
IDKY	I don't know why
IDMB	I'll do my best
IDN	I don't know
IDNDT	I did not do that
IDNK	I do not know
IDR	I don't remember
IDS	I'm dead serious
IDT	I don't think
IDTS	I don't think so
IDTT	I'll drink to that
IDU	I don't understand
IE	That is
IFAB	I found a bug
IFLY	I freaking love you
IFOCN	In front of computer naked
IFSFY	I feel sorry for you
IFVB	I feel very bad
IG	I guess
IG2P	I got to pee
iggy	Ignored
ight	Alright
IGI	I get it
IGN	In-game name
IGTP	I get the point
IH8U	I hate you
IHA	I hate acronyms
IHI	I have it
IHM	I hate Mondays
IHU	I hate you
IHY	I hate you
II	I'm impressed
IIOK	If I only knew
IIR	If I remember
IIRC	If I remember correctly
IIT	I'm impressed too
IIWY	If I were you
IJC2SILU	I just called to say I love you
IJDGAF	I just don't give a f***
IJWTK	I just want to know
IJWTS	I just want to say
IK	I know
IKHYF	I know how you feel
IKR	I know, right?
IKWUM	I know what you mean
IKWYM	I know what you mean
IKYD	I know you did
ILAMY	I love and miss you
ill	Cool
ILMM	I love my man
ILU	I love you
ILU	I like you
ILU2	I love you too
ILUB	I love you baby
ILUGTD	I love you guys to death
ILUM	I love you man
iluvu	I love you
ILY	I love you
ILY2	I love you too
ILYFAE	I love you forever and ever
ILYFE	I love you for eternity
ILYK	I'll let you know
ILYL	I love you lots
ILYLC	I love you like crazy
ILYMTYWEK	I love you more than you would ever know
ILYSM	I love you so much
ILYWAMH	I love you with all my heart
IM	Instant message
IM	Instant Messenger
ima	I'm going to
ima	I'm
IMA	I might add
IMAO	In my arrogant opinion
imba	Imbalanced
IMBO	In my biased opinion
IMCO	In my considered opinion
IMD	In my dreams
IME	In my experience
IMHARO	In my humble and respectful opinion
IMHBMAO	In my humble but most accurate opinion
IMHO	In my honest opinion
IMHO	In my humble opinion
IMIO	In my infallible opinion
imma	I'm gonna
IMNSHO	In my not so humble opinion
IMNSVHO	In my not so very humble opinion
IMO	In my opinion
IMOBO	In my own biased opinion
imot	I'm on that
IMPO	In my personal opinion
IMPOV	In my point of view
IMS	If memory serves
IMS	I am sorry
IMSO	In my sovereign opinion
imtg	In meeting
IMU	I miss you
IMVHO	In my very humble opinion
IMVU	Instant Messaging Virtual Universe
IMY	I miss you
IMYA	I miss you already
inb4	In before
INBD	It's no big deal
inc	Incoming
indie	Independent
indy	Independent
indy	Indianapolis
info	Information
init	Initialize
INPO	In no particular order
INR	I know right
INRS	It's not rocket science
Instalock	Instantly choose character
int	Intellect
intel	Intelligence
Intexticated	Texting while driving
INU	I need you
inv	Invite
IOB	Insulin on board
IOH	I'm out of here
IOIT	I'm on Irish time
IOKIYAD	It's OK if you're a Democrat
IOKIYAR	It's OK if you're a Republican
IONO	I don't know
IOU	I owe you
IOW	In other words
IPN	I'm posting naked
IPO	Initial public offering
IPQ	Internet printable coupon
IR	In room
IR8	Irate
IRDK	I really don't know
IRL	In real life
IRSTBO	It really sucks the big one
IRT	In regards to
IS	I'm sorry
ISF	Insulin Sensitivity Factor
ISH	I'm so hungry
ISO	In search of
ISO	Is seeking other
ISP	Internet Service Provider
ISTM	It seems to me
ISTR	I seem to recall
ISWYM	I see what you mean
ITBOOTP	In the bathroom, out of toilet paper
ITFA	In the final analysis
ITIGBS	I think I'm going to be sick
ITILY	I think I love you
ITILY	I think I like you
ITMT	In the meantime
ITR	Income Tax Return
ITR	Internet Talk Radio
ITR	In the room
ITRW	In the real world
ITSFWI	If the shoe fits, wear it
ITTWACW	I thought this was a Christian website
ITYF	I think you'll find
ITYM	I think you mean
ITYS	I told you so
IVL	In virtual life
IW2BWU	I want to be with you
IWALU	I will always love you
IWALY	I will always love you
IWBB	I will be back
IWBNI	It would be nice if
IWTY	I would tickle you
IWU	I want you
IYKWIM	If you know what I mean
IYO	In your opinion
IYQ	I like you
IYSS	If you say so
IYSWIM	If you see what I mean
iz	Is

J	Joking
J/K	Just kidding
J/P	Just playing
J/W	Just wondering
J2LYK	Just to let you know
J4F	Just for fun
J4G	Just for grins
jab	Injection
JAF	Just a friend
JAM	Just a minute
Janky	Of poor or inferior quality
JAS	Just a second
JASE	Just another system error
jb/c	Just because
jbc	Just because
jc	Jewelcrafter
JC	Just curious
JC	Just chilling
JC	Just checking
JCI	Just checking in
jelly	Jealous
Jellz	Jealous
Jerry	Baby slime
Jet	Leave quickly
JFF	Just for fun
JFGI	Just flippin' Google it
JFI	Just for information
JFK	Just freakin' kidding
JIC	Just in case
JIT	Just in time
JJ	Just joking
JJA	Just joking around
JJWY	Just joking with you
JK	Just kidding
JLMK	Just let me know
JLo	Jennifer Lopez
JLUK	Just letting you know
JMHO	Just my humble opinion
JMO	Just my opinion
Jock	Athlete
John	Toilet
JOOC	Just out of curiosity
Joshing	Joking
JP	Jurassic Park
JP	Just playing
JS	Just saying
JSYK	Just so you know
JTLYK	Just to let you know
Juice	Power and influence
Juiced	Excited
JUIL	Just you I love
Jungler	Jungle killing player
Jungling	Killing neutral monsters in jungle
JW	Just wondering

K	OK
K	Kiss
K3U	I love you
Kappa	Sarcasm
kara	Karazhan
KAS	Kicking and screaming
KB	Kiss back
KDA	Kills deaths assists
KDR	Kill death ratio
kek	Korean laugh
kek	WoW Orcish laugh
keke	Korean laugh
kewl	Cool
kewt	Cute
KFC	Kentucky Fried Chicken
KFC	Kid's Fattening Clinic
KFY	Kiss for you
kgo	Ok, go
KHUF	Know how you feel
KHYF	Know how you feel
KIA	Killed in action
Kicks	Shoes
Kicks	Just for fun
KIK	Laughing out loud
Kinda	Kind of
KIR	Keepin' it real
KISS	Keep it simple, stupid
KIT	Keep in touch
Kiting	Moving while avoiding attack
KK	Kiss kiss
KK	OK
KKWT	Knock knock, who's there?
kl	Kool
KM	Kiss me
KMA	Kiss my a**
KMAB	Kiss my a** b****
KMB	Kiss my butt
KML	Killing myself laughing
KMMFA	Kiss my mother f****** a**
KMP	Keep me posted
KMSL	Killing myself laughing
KMSO	Knocked my socks off
KMUF	Kiss me you fool
KNP	OK, no problem
KOL	Kiss on lips
KOS	Kill on site
KOS	Kid over shoulder
Kosher	Acceptable
KOTC	Kiss on the cheek
KOTL	Kiss on the lips
KOTOR	Knights of the Old Republic
kptondl	Keep it on the down low
ks	Kingslayer
KS	Kill steal
KSC	Kinda sorta chuckle
kthx	OK, Thanks
kthxbai	OK, thanks, bye
kthxbi	OK thanks, bye
KUTGW	Keep up the good work
kw	Know
KWIM	Know what I mean
KWIS	Know what I'm saying
kwl	Cool
KYFM	Kiss yourself for me
KYSOTI	Keep your stick on the ice

L	Laughing
L/F/E	Lovers forever
L2M	Listening to music
L2P	Learn to play
l33t	Leet
L4D	Left for Dead
L4D2	Left for Dead 2
L8	Late
L8er	Later
l8r	Later
L8rg8r	Later gator
LA	Laughing a lot
laf	Laugh
laffing	Laughing
LAFS	Love at first sight
LAL	Laughing a lot
LAL	Laugh a little
LAM	Leave a message
Lamer	Lame person
LAN	Local Area Network
lane	MOBA map path
Laning	Staying in a lane
LARP	Live action role-playing
larper	Live action role-player
larping	Live action role-playing
LAST	Locate, Access, Stabilize, Transport
lawl	LOL
Lawls	Laugh out loud
lawlz	Laugh out loud
LBF	Later, best friend
LBR	Let's be real
LBVS	Laughing but very serious
LC	Let's celebrate
LD	Later dude
LDR	Long distance relationship
Leech	Freeloader
lefties	Liberals
legit	Legitimate
Lemeno	Let me know
LEP	Love emo people
Lewt	Loot
LF	Looking for
LF1M	Looking for one more
LFD	Left for day
LFG	Looking for group
LFK	Let's french kiss
LFM	Looking for more
LFTD	Left for the day
LFTD	Laugh for the day
LFW	Looking for work
LGBT	Lesbian, Gay, Bisexual, and Transgender
LGBTQ	Lesbian, Gay, Bisexual, Transgender, and Queer
LHM	Lord help me
LHO	Laughing head off
LHU	Lord help us
LHUA	Lord help us all
LI	LinkedIn
lib	liberal
LIFO	Last in, first out
LIG	Life is good
lil	Little
ling	Zergling
LIQ	Laughing inside quietly
LIS	Laughing in silence
LJK	LOL just kidding
lk	Like
LL	Later loser
LL&P	Live long and prosper
LLACP	Laughing like a crazy person
LLC	Laughing like crazy
LLH	Laughing like heck
LLOL	Literally laughing out loud
LLPOF	Liar liar pants on fire
LLS	Laughing like s***
LLTA	Lots and lots of thunderous applause
LM	Letters mailed
LMA	Leave me alone
LMAO	Laughing my a** off
LMAOROF	Laughing my a** off rolling on the floor
LMAOROTF	Laughing my a** off and rolling on the floor
LMAOTC	Laughing my a** off the chair
LMBO	Laughing my butt off
LMFAO	Laughing my freakin' a** off
LMFAO	Laughing my fat a** off
LMFAOPIMP	Laughing my freaking a** off peeing in my pants
LMFBO	Laughing my fat butt off
LMFHO	Laughing my freakin' heart out
LMGTFY	Let me Google that for you
LMHO	Laughing my hiney off
LMIRL	Let's meet in real life
LMK	Let me know
LML	Love my life
LML	Laughing mad loud
LMO	Leave me one
LMO	Let's make out
LMS	Let me see
LMS	Like my status
LMS	Learning Management System
LMSO	Laughing my socks off
LMWAO	Laughing my white a** off
LNK	Love and kisses
LOC	Load of crap
LOE	Level of effort
LOFL	Laughing out freakin' loud
LOI	Laughing on the inside
LOL	League of Legends
LOL	Little old lady
LOL	Lots of love
LOL	Laughing out loud
LOLA	Love often, laugh a lot
LOLAWS	Laugh out loud and with style
LOLHK	Lots of love, hugs, and kisses
LOLOL	Lots of laugh out louds
LOLROFLMAO	Laughing out loud, rolling on floor, laughing my a** off
LOLUSA	Laughing out loud until sides ache
lolz	Laugh out louds
LOM	Low on mana
LOML	Love of my life
LOMLILY	Light of my life, I love you
Loot	Treasure
LOQ	Laugh out quietly
LOS	Line of sight
LOTFLOL	Lying on the floor laughing out loud
LOTI	Laughing on the inside
LOTR	Lord of the Rings
LOTV	Legacy of the Void
LQTM	Laughing quietly to myself
LRL	Laugh real loud
LRU	Least Recently Used
LSHIFOMD	Laughing so hard I fell off my dinosaur
LSHMSFOAIDMT	Laughing so hard my sombrero fell off and I dropped my taco
LSHTMSFOAIDMT	Laughing so hard that my sombrero fell off and I dropped my taco
LSS	Long story short
LST	Long-sleeve t-shirt
LTD	Lovers till death
LTHTT	Laughing too hard to type
LTM	Laughing to myself
LTMQ	Laughing to myself quietly
LTNS	Long time, no see
LTP	Let's talk privately
LTR	Long term relationship
ltr	Later
ltr	Letter
LTS	Laughing to self
LU	Love you
lu4ever	Love you forever
LUA	Love you a lot
LUB	Love you, bye
LUGLS	Love you guys like sisters
LUL	Love you lots
LULAB	Love you like a brother
LULAF	Love you like a friend
LULAS	Love you like a sister
lulz	LOL
LUM	Love you man
luv	Love
luzr	Loser
lv	Love
lv1	Leave one
lvl	Level
LWT	Laughing with tears
LY	Love ya
LYA	Love you always
LYK	Let you know
LYL	Love you lots
LYLAB	Love you like a brother
LYLAS	Love you like a sister
LYLC	Love you like crazy
LYMI	Love you, mean it
lyn	Lying
LYSM	Love you so much
LZ	Led Zeppelin

m	Male
M$	Microsoft
m.02	My two cents
M/F	Male or female
M02	My two cents
m8	Mate
mab	Maybe
Maccas	McDonald's
Mack	Flirt
Macro	Economy management skill
mag	Magazine
Main	Main character
Manscaping	Strategic shaving of male body hair
mats	Materials
MB	My bad
MBF	My best friend
MBP	MacBook Pro
MBS	Mom behind shoulder
MC	Mind Control
MC	Minecraft
MCM	Man-crush Monday
md@u	Mad at you
md@ufn	Mad at you for now
MDI	Multiple Daily Injections
MDIAC	My dad is a cop
MDPS	Melee damage per second
me2	Me too
mech	Mechanical units
meds	Medications
MEGO	My eyes glaze over
meh	Whatever
Metagame	Outside game preparation and strategies
MF	Mother f***er
MFB	Mother F***ing B****
MGB	May God bless
mgmt	Management
mhm	Mm-hmm
MHOTY	My hat's off to you
MI	Marching Illini
MIA	Missing in action
MIB	Mint in box
MIB	Men in Black
MIBG	Mental image be gone
Micro	Unit micromanagement skill
mid	Middle lane
mid	Middle
MIL	Mother-in-law
MIMAS	May I make a suggestion
min	Minute
mins	Minutes
MIPS	Millions of Instructions Per Second
MIR	Mail-in rebate
MIRL	Meet in real life
mishu	Miss you
mk	Okay
mka	Make additions
mkay	OK
MLB	Major League Baseball
MLG	Major League Gaming
MLIA	My life is average
MLP	My Little Pony
MM	Merry meet
MM	Missing my
MM	Make me
MM	Music Monday
MMA	Mixed martial arts
MMA	Meet me at
MMAMP	Meet me at my place
MMB	Message me back
MMBBG	Massively Multiplayer Browser-Based Game
MMFU	My mate fancies you
MMHRD	Many Many Happy Returns of the Day
mmk	OK
MML	Made me laugh
MMM	Marine, Marauder, Medivac
MMO	Massively multiplayer online
MMOB	Mind my own business
MMOG	Massively Multiplayer Online Game
MMORPG	Massively multiplayer online role-playing game
MMRD	My mind is rolled down
MMS	Multimedia Messaging Service
mng	Manage
mngr	Manager
MO	Modus operandi
mo	More
moar	More
mob	Mobile
mob	Monster
MOBA	Multiplayer online battle arena
mod	Moderator
mod	Modification
mofo	Mother F*****
MOH	Maid of Honor
MOH	Medal of Honor
Mojo	Attractive talent
MOO	My own opinion
MOOC	Massive open online course
Mooch	Freeload
Moolah	Money
MOP	Mists of Pandaria
morf	Male or female
MOS	Mom over shoulder
Moss	Chill
MOTAS	Members of the appropriate sex
MOTD	Message of the day
MOTOS	Members of the opposite sex
MOTSS	Members of the same sex
MOTU	Masters of the Universe
MOTU	Mark of the Unicorn
MP	Merry part
mp5	Mana per five seconds
MQ	Manufacturer coupon
MR	Mentally Retarded
MRA	Men's rights activist
MRT	Modified retweet
MRU	Most recently used
MS	Microsoft
Ms	Miss
MSB	My sexy b****
msg	Message
MSRP	Manufacturer's suggested retail price
MST	Must see today
MST3K	Mystery Science Theater 3000
MT	Modified tweet
MT	Mistype
MTF	More to follow
MTFBWU	May the Force be with you
MTFBWY	May the Force be with you
mtg	Meeting
mth	Month
MU	Miss you
MU@	Meet you at
muah	Kiss
MUBAR	Messed up beyond all recognition
MUD	Multi-User Dimension
mula	Money
Mule	Alternate character for storage
mum	Mom
mut	Mutilate
muta	Mutalisks
MVH	With best regards
MVP	Most valuable player
MW	Most welcome
mwa	Kiss
mwah	Kiss
mwahugz	Kisses and hugs
MYB	myYearbook
MYOB	Mind your own business
mysp	MySpace
my_____	Myspace

n	And
n	In
N/A	Not applicable
N/A	Not Available
N/C	No comment
N/C	Not cool
n/m	Nevermind
N/M/H	Nothing much here
N/R	No reserve
n00b	Newbie
N1	Nice one
N1C	No one cares
N2M	Not too much
N2MH	Not too much here
N2W	Not to worry
N64	Nintendo 64
n8kd	Naked
NAC	Not a chance
nah	No
Nal	Nationality
narc	Tattle tale
Nark	Informant
Natural	Natural expansion
naw	No
nax	Naxxaramas
naxx	Naxxaramas
NB	Not bad
NB	Please note
NBA	National Basketball Association
NBD	No big deal
NBJF	No brag, just fact
NBL	Not bloody likely
NBSP	No bull s*** please
NC	No comment
NC	Not cool
NC	Nice call
NCZ	No capture zone
nd	And
NDS	Nintendo DS
ne	Any
ne1	Anyone
ne1er	Anyone here
NED	No expiration date
neh	No
nemore	Anymore
Nerf	Weaken
NES	Nintendo Entertainment System
Netherrack	Nether block
nethng	Anything
neva	Never
neway	Anyway
newaze	Anyways
newb	Newbie
NF	Not funny
NFC	National Football Conference
NFI	No freaking idea
NFI	No further information
NFIAH	Never fear, I am here
NFL	Not freakin' likely
NFL	National Football League
NFW	No freakin' way
NG	No good
NGL	Not gonna lie
NH	Nice hand
NHL	National Hockey League
NIB	New in box
NIMBY	Not in my backyard
NIN	Nine Inch Nails
Ninja	Loot stealer
NIP	New in package
nite	Night
NITM	Not in the mood
NJ	Nice job
NJ	No joke
NK	No kidding
NKOTB	New Kids on the Block
NKOTBSB	New Kids on the Block and Backstreet Boys
NKZ	No kill zone
NL	Not likely
NL	National League
NL	No limit
NLT	No later than
nm	Nevermind
NM	Not much
NMH	Not much here
NMHJC	Not much here, just chilling
NMJC	Nothing much, just chillin'
NMJCY	Not much, just chilling, you?
nmtn	Nevermind that now
NMU	Not much, you?
NN2R	No need to reply
NNITO	Not necessarily in that order
NNTO	No need to open
NNTR	No need to reply
no	Know
no1	No one
NOBMR	None of my business, right
NOIRL	No one is really laughing
NOM	No offense meant
NOMB	None of my business
noob	Newbie
nooblet	Young newbie
nooblord	Ultimate newbie
NOS	New old stock
NOTD	Nail of the day
nottie	Unattractive person
NOTTOMH	Not off the top of my head
NOYB	None of your business
NP	Nice play
NP	Neopets
NP	No problem
NPC	Non-player character
NPS	No problem sweetie
NR	No reserve
NRFB	Never removed from box
NRN	Not right now
NRN	No reply necessary
NS	Nice shot
NS	No s***
NSA	No strings attached
NSFV	Not safe for vegetarians
NSFW	Not suitable for women
NSFW	Not safe for work
NSISR	Not sure if spelled right
NSS	No s*** Sherlock
NT	No thanks
NT	Nice try
NTIM	Not that it matters
NTL	Never too late
NTMY	Nice to meet you
NTN	No thanks needed
NTS	Note to self
NTY	No thank you
nub	Newbie
nuff	Enough
nufn	Nothing
NUIGB	Not until I get back
nuke	Nuclear missile
Num	Tasty
nvm	Nevermind
nvr	Never
nvrm	Nevermind
NW	No way
nWo	New World Order
NWO	New world order
NWOT	New without tags
NWT	New with tags
nxt	Next
NYB	Not your business

O&O	Over and out
O4U	Only for you
OA	Over acting
OAO	Over and out
OAR	On a roll
OBO	Or best offer
obs	Obviously
OBTW	Oh, by the way
obvi	Obviously
OC	Of course
OCD	Obsessive compulsive disorder
od	Overdose
OEM	Original Equipment Manufacturer
ofc	Of course
OFL	Out for lunch
OG	Original gangster
OGW	Oh gosh why
oh	Overheard
ohemgee	Oh my gosh
OIC	Oh, I see
OICN	Oh, I see now
OITNB	Orange is the New Black
oiy	Hi
OJ	Orange juice
OK	One kiss
OL	Old lady
OLPC	One Laptop Per Child
OLTL	One Life to Live
OM	Oh man
OM	Old man
OMAM	Of Mice and Men
OMAM	Of Monsters and Men
OMC	Oh my Carlisle
OMD	Oh my darn!
OMDB	Over my dead body
OME	Oh my Edward
OMFG	Oh my freaking gosh
OMFGAZ	Oh my freaking gosh and zounds
OMFGYASB	Oh my freaking gosh, you're a sexy beast
OMG	Oh my gosh
OMGD	Oh my gosh, duh
OMGF	Oh my godfather
OMGN	Oh my gosh noob
OMGROFLMAO	Oh my gosh, rolling on the floor laughing my a** off
OMGWTFBBQ	Oh my gosh, what the f***, barbeque
OMGYS	Oh my gosh you suck
OMH	Oh my heavens!
OMJ	Oh my Jonas
OML	Oh my L...
OMM	On my mind
OMOHOD	One minute, one hour, one day
OMW	On my way
ONCO	Or nearest cash offer
oneshot	One shot completion
onl	Online
ONNA	Oh no, not again
ONO	Or nearest offer
onoz	Oh no
ONYD	Oh no you didn't
OO	OpenOffice
OO	On order
OO	Over and out
OOAK	One of a kind
OOC	Out of character
OOH	Out of here
OOM	Out of mana
oomf	Great strain
OOMF	One of my followers
OOO	Out of office
OOP	Out of pocket
OOP	Out of print
OOT	Out of town
OOT	Out of topic
OOTB	Out of the box
OOTD	Outfit of the day
OOYFM	Out of your freaking mind
OP	Original poster
op	Overpowered
opa	Greek exclamation
OPI	Overpaid idiot
OPK	Ovulation predictor kit
OPM	Other people's money
orly	Oh really
ORP	Original Retail Price
OSLT	Or something like that
OT	Overtime
OT	Off topic
OT	Other topic
OTA	Over the air
otay	Okay
OTB	Off the boat
OTC	Over the counter
OTE	Over the edge
OTFLMAO	On the floor laughing my a** off
OTG	On the ground
OTGL	On the ground laughing
OTH	Off the hook
OTL	Out to lunch
OTOH	On the other hand
OTP	On the phone
OTP	One true pairing
OTS	Off the subject
OTS	On the scene
OTS	Open two seater
OTT	Over the top
OTTH	On the third hand
OTTOMH	Off the top of my head
OTW	On the way
OTW	Off to work
outta	Out of
ovie	Overlord
ownage	Completely owned
Owned	Embarrassed

p/w	Password
p911	Parent alert!
P@H	Parents at home
PA	Parent alert
Pad	House
PAH	Parents at home
Paper	Money
pat	Patrol
PAW	Parents are watching
PAX	Peace and Love
PAYE	Pay as you earn
PAYG	Pay as you go
PB&J	Peanut butter and jelly
PBE	Public beta environment
PBS	Public Broadcasting Service
PBUH	Peace be upon Him
PC	Personal computer
PC	Politically correct
PC4PC	Picture comment for picture comment
PCID	Putting clothes in dryer
PCM	Please call me
PDA	Public display of affection
PDA	Personal Digital Assistant
PDH	Pretty darn hot
PDQ	Pretty darn quick
PE	Physical education
PEBCAC	Problem exists between chair and computer
PEBCAK	Problem exists between chair and keyboard
PEBKAC	Problem exists between keyboard and chair
PED	Performance enhancing drug
peeps	People
Permabanned	Permanently banned
perv	Pervert
PF	Planetary Fortress
pf	Preflop
PF	Pink Floyd
PFA	Please find attached
PFO	Pissed and fell over
PFR	Plasma, Frag, Rocket
pfr	Preflop raise
PG	Pretty good
PGP	Preferred Gender Pronoun
PHAT	Pretty hot and tempting
phobar	Photoshopped beyond all recognition
Photobomb	To pose in the background of a picture being taken
pic	Picture
PIMP	Peeing in my pants (laughing)
PIN	Personal identification number
PIO	Pass it on
PIOG	Posted in other groups
PIR	Parent in room
PIR	People in room
PITA	Pain in the a**
pix	Pictures
PJ	Pearl Jam
PJDWYS	Personal joke, don't worry yourself
pjs	Pajamas
PK	Player Kill
pkmn	Pokmon
PL	Punch line
PL	Pig latin
Pl	Playlist
pl	Pinkliner
PL&	Planned
pl0x	Please
pl8	Plate
Planking	Lying face down
Plastic	Credit card
pld	Played
PLJ	Peace, love, joy
PLMK	Please let me know
plox	Please
pls	Please
plz	Please
plzrd	Please read
PM	Postmeridian
PM	Private message
PM5K	Powerman 5000
PMD	Pokmon Mystery Dungeon
PMFJI	Pardon me for jumping in
PMJI	Pardon my jumping in
PMKI	Pretty much killin' it
PMP	Peed my pants
PMPL	Piss my pants laughing
pmsl	Piss myself laughing
PMWOF	Putting more wood on the fire
PNAR	Poppin and a ranging
PNP	Plug and Play
Po-po	Police
POAS	Pee on a stick
POC	Proof of concept
POC	Point of contact
POC	Piece of crap
poed	P*ssed off
POMS	Peace out my sucka
POMS	Parents over my shoulder
POS	Power of suggestion
POS	Parent over shoulder
POS	Piece of s***
posbl	Possible
Poser	Pretender
pot	Potion
POTB	Pat on the back
POTC	Pirates of the Caribbean
POTC	Peck on the cheek
POTO	Phantom of the Opera
POTUS	President of the United States
POUS	President of the United States
POV	Point of view
POW	Prisoner of war
PP	Patterned paper
PP	Pause please
PP	Power Points
ppd	Postpartum depression
PPDA	Parents pacing de area
ppl	People
ppp	Peace
PPV	Pay-Per-View
PR	Public relations
Presh	Precious
PRL	Parents are listening
probs	Probably
proc	Programmed random occurrence
prof	Professor
prolly	Probably
promo	Promotion
props	Recognition
prot	Protection
prt	Partial retweet
prvt	Private
PRW	Parents are watching
ps	Postscript
PS2	PlayStation 2
PS3	PlayStation 3
PSOG	Pure stroke of genius
PSP	PlayStation Portable
PST	Please send tell
PTB	Powers that be
PTFO	Play the freaking objective
PTIYPASI	Put that in your pipe and smoke it
PTL	Praise the Lord
PTL	Player to left
PTM	Please tell me
PTO	Paid time off
PTO	Pass this on
PTR	Public test realm
PTR	Player to right
PTSB	Pass the sick bucket
PUG	Pick up group
PUK	PIN unlock key
puks	Pick up the kids
Pull	Enter combat
Pumped	Very excited
PUSIMP	Put yourself in my position
PVC	Player versus computer
PVE	Player versus environment
PVP	Player versus player
PvP	Protoss versus Protoss
PvT	Protoss versus Terran
pvt	Private
PvZ	Protoss versus Zerg
pw	Password
pwn	Own
pwn2own	Pwn to Own Contest
pwn3d	Owned
pwnage	Ownage
pwnd	Owned
pwned	Owned
pwnt	Owned
PWOF	Putting wood on the fire
PWT	Poor white trash
PYHOOYA	Pull your head out of your a**
PYSIMP	Put yourself in my place
PYT	Pretty young thing

Q	First champion ability
q	Coupon
Q4U	Question for you
QFE	Question for everyone
QFE	Quoted for emphasis
QFT	Quoted for truth
QQ	Quick question
qqn	Looking
QRG	Quick reference guide
qt	Cutie
qtpi	Cutie Pie

r	Are
r8	Rate
rad	Radical
Ragequit	Angrily exiting
Raid	Raid group
RAK	Random act of kindness
Rake	Poker site commission
RATM	Rage Against The Machine
rawr	Roar
rax	Barracks
RBAY	Right back at you
RBTL	Read between the lines
RDF	Real deal feeling
rdnk	Redneck
RDPS	Ranged damage per second
RDT	Relationship defining talk
rdy	Ready
re	Replay
re	Regarding
RE	Resident Evil
ref	Referee
Rehi	Hi again
rents	Parents
rep	Reputation
resq	Rescue
resto	Restoration
rez	Resurrection
RFC	Request for comment
RFP	Request for proposal
rgd	Regard
rgds	Regards
RHCP	Red Hot Chili Peppers
RHIP	Rank hath its privileges
Ride	Vehicle
ridic	Ridiculous
RIP	Rest in peace
RL	Real life
rly	Really
Rm	Room
RMA	Return Merchandise Authorization
RMAH	Real money auction house
RML	Read my lips
RMP	Rogue, Mage, Priest
Rn	Russian
rn	Run
RNG	Random number generator
rnt	Aren't
ROBL	Rolling on back laughing
robo	Robotics Facility
ROF	Rolling on floor
ROFL	Rolling over freakin' laughing
ROFL	Rolling on the floor laughing
ROFLMAO	Rolling on floor, laughing my a** off
ROFLMAOQWERTY	Rolling on floor laughing my a** off at the keyboard
ROFLMAOWEC	Rolling on floor laughing my a** off while eating cookie
ROFLMBWAO	Rolling on floor laughing my big white a** off
ROFLMFAO	Rolling on the floor laughing my freakin' a** off
ROFLMRO	Rolling on the floor laughing my rear off
ROFLOL	Rolling on the floor laughing out loud
ROFLTRABTD	Rolling on floor laughing, thinking Republicans are better than Democrats
ROFLUSA	Rolling on floor laughing until sides ache
ROLF	Rolling on laughing floor
ROLMBO	Rolling over laughing my butt off
ROM	Rough order of magnitude
ROM	Emulator game
ROTF	Rolling on the floor
ROTFL	Rolling on the floor laughing
ROTFLH	Rolling on the floor laughing hysterically
ROTFLMAO	Rolling on the floor laughing my a** off
ROTFLMBO	Rolling on the floor, laughing my behind off
ROTFLMFAO	Rolling on the floor laughing my fat a** off
ROTFLMFAO	Rolling on the floor laughing my f****** a** off
ROTFLOL	Rolling on the floor laughing out loud
ROTS	Right on the spot
ROUS	Rodents of unusual size
rox	Rocks
roxorz	Rocks
RP	Role play
RPC	Role play chat
RPG	Role playing game
RPMO	Really pissing me off
RQ	Real quick
RSN	Real soon now
RSVP	Rpondez s'il vous plat
RT	Retweet
RT	Real-time
RTB	Real-time bidding
RTF	Return the favor
RTFA	Read the flippin' article
RTFB	Read the flippin' book
RTFFAQ	Read the flippin' FAQ
RTFM	Read the flippin' manual
RTFMM	Read the flippin' manual, moron
RTFS	Read the flippin' source
rthx	Retweet thanks
RTI	Real-Time Interruption
RTS	Real-time strategy
RU	Are you
RUB	Are you back
RUC	Are you coming?
RUCB	Are you coming back?
rucmng	Are you coming?
RUFR	Are you for real
RUMOF	Are you male or female?
RUN	Are you in?
RUOK	Are you OK?
RUS	Are you serious?
RUSOS	Are you stupid or something?
RUT	Are you there?
RW	Real world
RWA	Ready, willing, and able
Rx	Prescription
RYC	Regarding your comment
RYFS	Are you freakin' serious?

T1D	Type 1 Diabetes
t2go	Time to go
T2M	Talk to me
T2U	Talk to you
T2UL	Talk to you later
t2ul8er	Talk to you later
t2ul8r	Talk to you later
T4LMK	Thanks for letting me know
T4P	Thanks for posting
T4T	Thanks for trade
TA	Thanks again
TA	Teaching assistant
TAAHM	Two and a Half Men
tab	Talking about
TAC	That ain't cool
Tada	Announcement
TAFN	That's all for now
Tank	Strong character
TANSTAAFL	There ain't no such thing as a free lunch
tard	Retard
TARFU	Things are really foobarred up
TARFU	Things are really fouled up
TAT	This and that
tat	Tattoo
TAU	Thinking about you
TAWOG	The Amazing World of Gumball
TAY	Thinking about you
TBA	To be announced
TBC	To be continued
TBCL	To be continued later
TBD	To be determined
TBE	To be edited
TBF	To be frank
TBF	To be fair
TBFU	Too bad for you
TBH	To be honest
TBQH	To be quite honest
TBR	To be released
TBR	To be resolved
TBR	To be revised
TBR	To be read
TBT	Throwback Thursday
TBTG	Thanks be to God
TBY	Teacher behind you
TC	Take care
TC	That's cool
TCB	Taking care of business
TCCIC	Take care 'cause I care
TCFN	Take care for now
TCG	Trading card game
TCO	Taken care of
TCOB	Takin' care of business
TCOOD	Taking clothes out of dryer
TCWB	Take care, write back
td	Touchdown
TDL	The Do LaB
TDM	Team Death Match
TDSWJS	The Daily Show with Jon Stewart
TDTM	Talk dirty to me
Tebowing	The position of praying with one knee on the ground
tech	Technology
Teemo	The swift scout
Teemo	Teenage Emo
teh	The
tel	Telephone
teme	Tell me
terribad	Terrible bad
TF	Twisted Fate
TF2	Team Fortress 2
TFB	Too freakin' bad
TFF	Twitter follower-friend
TFF	Too freakin' funny
TFK	Thousand Foot Krutch
TFLMK	Thanks for letting me know
TFTA	Thanks for the add
TFTI	Thanks for the information
TG	Thank goodness
TGFF	Thank God for Friday
TGIF	Thank goodness it's Friday
TH	Tears of happiness
Thang	Thing
Thanksgivukkah	Thanksgiving and Hanukkah
thanq	Thank you
Thar	There
thkq	Thank you
thnq	Thank you
tho	Though
Threads	Clothes
thru	Through
tht	That
THTH	Too hot to handle
thx	Thanks
TIA	Thanks in advance
TIC	Tongue in cheek
Tight	Awesome
Tight	Close
TIL	Today I learned
Tilted	Aggravated
TIPS	To improve professional service
TISNF	That is so not fair
TISU	This is so unfair
TITF	That is too funny
Tix	Tickets
TJI	Try joining in
TKA	Totally Kick A**
tl	Tell
TLA	Three letter acronym
TLC	Tender love and care
TLDR	Too long, didn't read
tlk	Talk
Tlkin	Talking
Tlking	Talking
TLTR	Too long to read
TM	Tell me
TM	Trademark
TM	Trouble maker
TM	Tickle me
TMA	Take my advice
TMAI	Tell me about it
TMB	Text me back
TMB	Tag me back
TMDF	To my dearest friend
TMFT	Too much free time
TMG	That's my girl
TMI	Too much information
TMNT	Teenage Mutant Ninja Turtles
tmrw	Tomorrow
TMSF	Too much Science Fiction
TMTH	Too much too handle
TNG	The Next Generation
TNT	Till next time
tnx	Thanks
TOC	Table of contents
TOD	Truth or dare
TOH	The other half
TOH	Typing one-handed
TOIOM	This one is on me
TOL	Thinking of laughing
tomoz	Tomorrow
Toodles	Goodbye
Tool	Stupid person
Toon	Alternate character
Tootles	Goodbye
Tootsies	Toes
Torch	To beat someone in competition
TOS	The Original Series
toss	Protoss
Totes	Totally
Tots	Tater tots
tots	Totally
TOU	Thinking of you
tourney	Tournament
TOW	The one with
TOW	The one where
TOWL	The one with love
TOY	Thinking of you
TPM	Tweets per minute
TPT	Trailer park trash
TPTB	The powers that be
TPvPZ	Terran Protoss versus Protoss Zerg
TQ	Thank you
TQVM	Thank you very much
Trash	Dungeon enemy mob groups
TRBL	Terrible
TRDMF	Tears running down my face
Troll	Offensive comments poster
Trolling	Posting offensive comments
Trolol	Laughing at troll
TRS	That really sucks
tru	True
TS	Tough stuff
TSNF	That's so not fair
TSS	This stuff sucks
TSS	Toxic Shock Syndrome
TSTL	Too stupid to live
TT	Talking to
TT	Trending topic
TT2T	Too tired to talk
TT4N	Ta-ta for now
TTBOMK	To the best of my knowledge
TTFN	Ta-ta for now
TTG	Time to go
TTKA	Time to kick a**
TTL	Time to live
TTL	Time to leave
TTL	Talk to you later
ttly	Totally
TTM	Talk to me
TTMN	Talk to me now
TTT	To the top
TTTE	Thomas the Tank Engine
TTTT	These things take time
TTTT	Too tired to talk
TTTT	To tell the truth
TTUL	Talk to you later
TTY	Talk to you
TTYAW	Talk to you after work
TTYIAB	Talk to you in a bit
TTYIAM	Talk to you in a minute
TTYL	Talk to you later
TTYLMF	Talk to you later, my friend
TTYLXOX	Talk to you later, hugs and kisses
TTYN	Talk to you never
TTYOOTD	Talk to you one of these days
TTYS	Talk to you soon
TTYT	Talk to you tomorrow
TTYVS	Talk to you very soon
TTYW	Talk to you whenever
TU	Thank you
tude	Attitude
TUI	Turning you in
Turf	Neighborhood
Turtling	Playing defensively
TUT	Totally unique thought
TvP	Terran versus Protoss
TvT	Terran versus Terran
TvZ	Terran versus Zerg
TWD	The Walking Dead
twds	Towards
Tweavesdropping	Eavesdropping on Twitter
Tweeps	Twitter peeps
Tweet	Twitter post
Tweetup	Twitter meetup
Twerk	Hip-gyrating dance move
Twerking	Shaking hips in a bouncing motion
Twewbie	Twitter newbie
TWHS	That's what he said
TWIMC	To whom it may concern
Twink	Powerful low-level character
Twinking	Leveling up with assistance
TWIS	That's what I said
TWIT	That's what I thought
Twitch	Video game streaming website
TWMA	Till we meet again
TWSB	This website sucks b***s
TWSI	That was so ironic
TWSS	That's what she said
TWTI	That was totally ironic
tx	Thanks
txt	Text
txtin	Texting
TY	Thank you
TYFA	Thank you for asking
TYL	Thank you Lord
TYM	Thank you much
TYT	Take your time
TYVM	Thank you very much

u	You
u-ok	You OK?
u/l	Upload
U2	You too
U2U	Up to you
Uber	The best
UCE	Unsolicited commercial e-mail
UDFI	You don't fit in
ugh	Disgusted
UKWIS	You know what I'm saying
ul	Unlucky
ul	Upload
ULKGR8	You look great
ult	Ultimate ability
UNADR	You need a doctor
Undies	Underwear
Unfriend	Remove Facebook friend
uno	You know
uok	You OK?
UOME	You owe me
ups	Jumping ability
UR	You are
UR	Your
UR2M	You are too much
ura	You're a
URA*	You are a star
URAB	You are a b****
URAL	You are a loser
uraqt	You are a cutie
URC	You are caught
ure	You're
URGR8	You are great
Urp	Vomit
urs4e	Yours forever
URSKTM	You are so kind to me
URTB	You are the best
urw	You're welcome
us	Ultrasound
USA	Until sides ache
USA	United States of America
USAD	You're such a dork
USB	You sexy b****
UT	You there?
UTG	Under the gun
UW	You're welcome
UX	User Interface
UY	Up yours

VBG	Very big grin
VBS	Very big smile
VC	Voice Chat
VE	Very emotional
Veg	Do nothing
Veggies	Vegetables
vent	Ventrilo
Vet	Veterinarian
Vet	Veteran
vfx	Visual effects
VG	Video game
VGC	Very good condition
Vibe	Atmosphere
vid	Video
vlog	Video blog
vlogger	Video blogger
VM	Voicemail
VN	Very nice
VNH	Very nice hand
VOD	Video on demand
VPIP	Voluntary put in pot
VR	Virtual reality
vs	Versus
VSC	Very soft chuckle

w/	With
W/B	Welcome back
w/e	Whatever
w/o	Without
w00t	Yay
w00t	Joy and excitement
W2F	Way too funny
W2G	Way to go
W2K	Windows 2000
W4U	Wait for you
W8	Wait
w84m	Wait for me
w8am	Wait a minute
w8ing	Waiting
w8n	Waiting
wa	What
Waa	Crying
Wack	Strange
WADITWB	We always did it that way before
WADR	With all due respect
WAEFRD	When all else fails, read directions
waggro	Wife aggro
wags	Wife and girlfriends
WAH	Work at home
WAHM	Work at home mom
Wail	Awesome
WAM	Wait a minute
wan2	Want to
Wannabe	Want to be
WAS	Wait a second
Wash	Result with no benefit
Wasted	Weak
wat	What
watev	Whatever
watevs	Whatever
WAY	Who are you?
WAY	What about you?
WAYD	What are you doing
WAYDRN	What are you doing right now
WAYDT	What are you doing tonight
WB	Way bored
WB	Write back
WB	Welcome back
WBP	Write back please
WBS	Write back soon
WBU	What about you
WBW	With best wishes
WBWYC	Write back when you can
WBY	What about you?
WC	Who cares
WC	Water closet
WCG	World Cyber Games
WCM	Web Content Management
WCM	Warcraft Movies
WCMS	Web Content Management System
WCS	StarCraft II World Championship Series
WCW	Woman-crush Wednesday
WCW	World Championship Wrestling
WD	Well done
WDIT	Why do I try
WDMB	Will do my best
WDTFS	What does the fox say?
WDUMBT	What do you mean by that?
WDUW	What do you want
WDYM	What do you mean?
WDYMBT	What do you mean by that?
WDYT	What do you think
we	Whatever
Webpany	Web Company
Wee	Expression of excitement
WEG	Wicked evil grin
wei	Whatever idiot
welp	Well
WEML	Whatever major loser
WEU	What's eating you?
weva	Whatever
Wewt	Woot
WFM	Works for me
wg	Wintergrasp
Wha	What
whatevs	Whatever
Whew	Expression of relief
Whip	Vehicle
Whipped	Tired
Whiz	Smart person
Whoa	Expression of surprise
Whomp	Low hitting sound
wht	What
WHU	Warcraft Hunters Union
WHYBAD	Where have you been all day
WHYBATT	Where have you been all this time
Wicked	Very cool
WIIFM	What's in it for me?
Wipe	Total death
WITR	Who's in the room
WITWW	What in the wide world
WITWW	Where in the wide world
WIYP	What is your problem
wk	Week
wkd	Wicked
wknd	Weekend
WL	Whatta loser
wld	Would
wlk	Walk
WLOL	Whip laugh out loud
WLYK	Will let you know
WMAO	Working my a** off
WMB	Write me back
WN	Why not
WNDITWB	We never did it this way before
WOA	Work of art
Woah	Expression of surprise
WOHM	Working outside home mom
WOL	Wings of Liberty
WOMBAT	Waste of money, brains, and talent
Wonky	Weird
Woot	Woohoo!
WOOT	We own the other team
WOOT	Waste of our time
WOOT	Way out of topic
woot	Wonderful loot
Word	Agree
WOS	Wife over shoulder
WOT	Waste of time
wot	What
WOTD	Workout of the day
WOTLK	Wrath of the Lich King
WOW	World of Warcraft
Wowzer	Wow
Wowzerz	Wow
woz	Worry
WP	WordPress
WP	Well played
WP	Wrong person
WPM	Words per minute
WPT	World Poker Tour
WR	Win ratio
wrisit	Where is it
WRT	With regard to
WRT	With respect to
WRU	Where are you
WRU@	Where are you at?
WRUD	What are you doing
wrudoin	What are you doing?
WSOP	World Series of Poker
wsp	Whisper
WT	What the
WTA	Winner takes all
WTA	Women tell all
WTB	Want to buy
WTBH	What the bloody h***
WTC	What the crap
WTF	What the f***
WTFAY	Where the f*** are you?
WTFE	What the frick ever
WTFNF	What the f****n f***
WTFO	What the f***; Over
WTFRU	Where the f*** are you?
WTG	Way to go
WTGP	Want to go private
WTH	What the heck
WTHDTM	What the heck does that mean?
WTHWT	What the heck was that?
WTMI	Way too much information
WTS	What the s***
WTS	Want to sell
WTT	Want to trade
wtv	Whatever
WTYAF	Who threw you a fish?
WU	What's up
WUA	What's up anyway?
Wub	Love
WUBU2	What have you been up to
WUD	What's up, dog?
WUD	What are you doing
WUF	Where you from?
WUF	Wow, you're funny
WUGF	What up girlfriend
Wuh	What
WUIGB	Wait until I get back
wup	What's up?
Wuss	Wimp
wut	What
WUU2	What are you up to
WUWT	What's up with that
wuz	Was
wv	With
WW	Well won
WW	Wrong Way
WW	Wrong Window
WWE	World Wrestling Entertainment
WWF	World Wrestling Federation
WWF	World Wildlife Fund
WWI	What was it
WWJD	What would Jesus do
WWTFW	What's with this f'd up world
WWWF	World Wide Wrestling Federation
WYB	When you buy
WYB	Watch your back
WYD	What you doing?
WYD	Who's your daddy?
WYGOWM	Will you go out with me
WYMM	Will you marry me?
WYSIWYG	What you see is what you get
WYWH	Wish you were here
W^	What's up

X	Kiss
xb	Xbox
xbf	Ex-boyfriend
xbl	Xbox Live
xc	Cross country
XD	Laughing out loud
XDD	Laughing especially hard
xep	Except
xfer	Transfer
xgf	Ex-girlfriend
xit	Exit
xitb4ili	Exit before I lose it
xlnt	Excellent
xmute	Transmute
XO	Kiss and Hug
XOX	Kiss, hug, kiss
XOXO	Hugs and kisses
xp	Experience
xt	Cross training
XTL	Cross the line
xx	Kisses
XYZ	Examine your zipper

Y	Why
Y	YMCA
Y	Yawning
Y/R	Yeah right
Y2K	You're too kind
ya	You
ya	Yes
YAA	Yet another acronym
YABA	Yet another bloody acronym
yada	Blah blah
yall	You all
Yarr	Angry pirate sound
YATB	You are the best
YBS	You'll be sorry
YBYSA	You bet your sweet a**
YCCOI	You can count on it
YD	Ya dig?
YD	Yes dear
ydg	Ya dig
YDI	You deserved it
yeap	Yes
yep	Yes
yepperz	Yes
yer	Your
Yesh	Yes
YF	You fail
YG2BJ	You've got to be joking
YGG	You go girl
YGM	You've got mail
YGTI	You get the idea
YHBT	You have been trolled
YHM	You have mail
YHS	Your hand sucks
YIM	Yahoo! Instant Messenger
YK	You're kidding
YKHII	You know how it is
YKI	You know it
YKW	You know what
YM	Your mom
YMBJ	You must be joking
YMMD	You made my day
YMMV	Your mileage may vary
YMSF	Your momma's so fat
yo	Hi
YOLO	You only live once
YOMANK	You owe me a new keyboard
YOOW	You're out of work
YOYO	You're on your own
YPML	You're pulling my leg
YR	Yeah, right
Yr	Your
YRAG	You are a geek
YRG	You are good
YRL	You are lame
yrp	Europe
yrs	Years
YS	Yours sincerely
YS	You suck
YSJ	You're so jealin
YST	You still there
YSW	Yeah sure whatever
YT	Your turn
YT	You there?
YT?	You there?
YTD	Year-to-date
YTF	Why the f***
yup	Yes
yupz	OK
YVW	You're very welcome
YW	You're welcome
YWA	You're welcome anyway
YWIA	You're welcome in advance
YYSS	Yeah yeah, sure sure
YYSSW	Yeah yeah, sure sure, whatever

Z	Zero
zing	Owned
ZOMFG	Oh my freakin' gosh!
ZOMG	Oh my gosh!
Zoning	Constraining enemy positions
ZvP	Zerg versus Protoss
ZvT	Zerg versus Terran
ZvZ	Zerg versus Zerg
ZZZ	Sleeping